XXXXXXXXXXXXXXXXXXXXX
X...................X
X...................X
X...................X
X...XXXXXXXXXXXXX...X
X...X...........X...X
X...X...........X...X
X...X...........X...X
X...XXXXXXXXXXXXX...X
X...................X
X.....G.............X
X...................X
XXXXXXXXXXXXXXXXXXXXX
