XXXXXXXXXXXXXXXXXXXXX
X...........X...X...X
X...........X...X...X
X...........X...X...X
XXXXXXXXX...X...X...X
X.......X...........X
X.......X...........X
X.......X...........X
X...X...XXXXXXXXX...X
X...X...........X...X
X...X.....G.....X...X
X...X...........X...X
XXXXXXXXXXXXXXXXXXXXX
